  1  1  1  5  1  1  3  1  9 26 11  1  1  1  1  1
  1  3  1  1  1  1  1  2  9 26 11  1  1  1  1  1
  1  1  1  1  1  1  1  5  9 26 11  1  1  1  1  1
  1  1  1  1  1  1 13 10 20 26 11  1  1  1  1  1
  1  1  5  1  1  1  9 26 26 26 11  1  1  1  1  1
  1  1  1  1  1  1  9 26 18  8 15  1  1  1  1  1
  1  1  1  1  1  1  9 26 11  1  1  1  1  1  1  1 
  1  1  3  1  1  1  9 26 11  1  1  1  1  1  1  1
  1  1  2  1  1  1  9 26 11  1  1  1  1  1  1  1
  1  1  1  1  1  1  9 26 11  1  1  1  1  1  1  1
  1  1  1  1  1  1  9 26 21 14  1  1  1  1  2  1
  1  1  1  1  1  1  9 26 26 11  1  1  1  1  1  1
  1  1  1  1  1  1  9 26 18 15  1  1  1  1  1  1
  1  1  1  5  5  2  9 26 21 14  1  1  1  1  1  1
  1  1  1  1  1  1  9 26 26 11  1  1  1  1  1  1
  1  1  1  1  1  1 12 19 26 11  1  5  1  1  1  1
  1  1  1  1  1  1  1  9 26 21 10 14  1  1  1  1
  1  4  1  1  1  1  2  9 26 26 26 11  1  1  1  1
  1  1  1  1  1  1  1 12  8 19 26 11  1  1  1  1
  1  2  1  3  1  1  1  1  1  9 26 11  1  1  1  1
  1  1  1  1  1  1  1  1 13 20 26 11  1  1  1  1
  1  1  1  1  1  1  3 13 20 26 26 11  1  1  1  1
  1  1  1  1  1  1  1  9 26 26 18 15  1  1  1  1
  1  1  1  1  1  1  1  9 26 18 15  1  1  1  1  1
  1  1  1  1 13 10 10 20 26 11  1  1  1  1  1  1
  1  1  1  1  9 26 26 26 26 11  1  1  1  1  1  1
  1  1  1  3  9 26 18  8  8 15  1  1  3  1  1  1
  1  5  1  1  9 26 11  1  4  1  1  1  3  1  1  1
  1  1  1  1  9 26 11  1  1  1  1  1  4  1  1  1
  1  1  1  1  9 26 11  1  1  1  1  1  1  1  1  1
  1  1  1  1  9 26 11  1  1  1  1  1  1  1  1  1
  1  1  1 13 20 26 11  1  1  1  1  1  1  1  1  1
  1  1  1  9 26 26 11  1  1  1  1  1  1  1  1  5
  1  1  1  9 26 18 15  1  1  1  1  1  1  1  1  5
  1  1  1  9 26 11  1  1  1  1  1  1  4  1  1  1
  1  1  1  9 26 11  1  1  1  1  1  1  1  1  1  3
  1  1  1  9 26 21 14  1  1  1  1  1  1  1  1  1
  1  1  1  9 26 26 11  1  1  1  1  1  1  1  1  1
  1  1  1 12 19 26 11  1  1  1  1  1  1  1  1  1
  1  1  1  1  9 26 11  1  1  1  1  1  1  1  1  1
  1  1  1  1  9 26 11  1  1  1  1  1  1  1  1  1
  1  1  1  1  9 26 21 14  1  1  1  1  1  1  1  1
  1  1  1  1  9 26 26 11  1  1  1  1  1  1  1  1
  1  1  1  1 12 19 26 11  1  1  1  1  1  1  3  1
  1  1  1 13 10 20 26 11  1  1  1  1  1  1  1  1
  1  1  1  9 26 26 26 11  1  1  1  1  1  1  1  1
  1  1  1  9 26 18  8 15  1  1  2  1  1  1  1  1
  1  1 13 20 26 11  1  1  1  1  1  1  1  1  1  1
  1  1  9 26 26 11  1  1  1  1  1  1  1  1  1  1
  1  1  9 26 18 15  1  1  1  1  1  1  1  1  1  1
  1  1  9 26 21 10 10 10 10 10 14  1  1  1  1  1
  1  1  9 26 26 26 26 26 26 26 11  1  1  1  1  1
  1  5 12  8  8  8  8  8 19 26 11  1  1  3  1  1
  1  1  1  1  1  1  1  1  9 26 11  1  1  1  1  1
  1  1  1  1  1  1  1  1  9 26 11  1  1  1  1  1
  1  1  1  1  1  1  1  1  9 26 11  1  1  1  1  1
  1  1  1  1  1 13 10 10 20 26 11  1  1  5  1  1
  1  1  1  1  1  9 26 26 26 26 11  1  1  1  1  1
  1  1  1  1  1  9 26 18  8  8 15  1  1  1  1  1
  1  1  1  1  1  9 26 11  1  1  1  1  1  1  1  1
  1  1  1  1  1  9 26 11  4  1  1  1  1  1  1  1
  1  1  1  1  1  9 26 11  1  1  1  1  1  1  1  1
  1  1  3  1  1  9 26 11  2  1  3  1  1  1  1  1
  1  1  1  1  1  9 26 11  1  1  1  1  1  1  1  1 
